#######    ##########
#h____#    #______m_#
#____m######________#
#___________________#
#_____######__m_____#
#######    ######_###
                #_#
             ####_#######
             #_e________#
             #______m___#
             #__m_______#
             ############