             ########
             #__m___###
##############________#
#_m___________________#
#_____#####___________#
#_____#   #_m_________#
#_____#   ##########__####
#__h__#            #_____#
#######            #e____#
                   #_____#
                   #######